level 1
6 10
2 2 2 0 0 0 0 0 0 0
2 2 2 2 2 2 0 0 0 0
2 2 2 2 2 2 2 2 2 0
0 2 2 2 2 2 2 2 2 2
0 0 0 0 0 2 2 2 2 2
0 0 0 0 0 0 2 2 2 0
### Các trường dữ liệu khác SH HI TG SP IN EN
IN
1 1 1 1
EN
4 7