level 10
10 14
2 2 2 0 0 0 0 0 2 2 2 2 2 2 
2 2 2 0 0 2 0 0 2 2 2 2 2 2 
2 2 2 0 0 0 0 0 2 2 2 2 0 0 
0 0 0 0 0 0 0 0 0 2 2 2 0 0 
0 0 0 0 0 0 0 0 0 0 0 2 2 0 
0 0 0 0 0 0 0 0 0 0 0 0 2 0 
0 0 0 0 0 0 0 0 0 0 0 0 2 0 
0 0 0 0 0 0 0 0 0 0 0 2 2 0 
0 0 0 0 2 2 2 2 2 0 0 2 2 0
0 0 0 0 2 2 0 0 2 2 2 2 2 0
### Các trường dữ liệu khác SH HI TG SP IN EN
IN
1 9 1 9
EN
1 1
TG 2 9 11
1 6 1 7 2 12 3 12
TG 1 9 5
1 3 1 4
SP 2 1 12
1 12 1 9
LSGOAL
9 11 1 1
LSGOAL A
9 5 8 11
LSGOAL B
4 11 7 11