level 11
10 12
0 2 2 2 2 0 0 0 0 0 0 0  
0 2 2 2 2 2 0 0 0 0 0 0  
0 2 2 2 0 0 0 0 0 0 0 0  
0 2 0 0 0 2 2 2 2 2 2 0 
0 2 0 0 0 2 2 0 0 2 2 0  
2 2 2 2 2 2 2 0 0 2 2 2  
0 0 0 0 0 2 2 0 0 0 0 2  
0 0 0 0 0 2 2 2 2 0 0 2  
0 0 0 0 0 2 2 2 2 2 2 2 
0 0 0 0 0 0 0 0 2 2 2 0 
### Các trường dữ liệu khác SH HI TG SP IN EN
IN
5 0 5 0
EN
1 2
HI 1 6 6
0 4 1 4
LSGOAL
1 2