level 12
10 13
0 0 0 0 0 0 0 0 0 0 0 0 2  
0 0 0 0 0 2 2 2 0 0 2 2 2 
0 0 0 0 0 2 2 2 2 2 2 2 0 
0 0 0 2 2 2 2 2 0 0 2 2 0
0 0 0 2 2 2 0 0 0 0 2 2 0
2 2 2 2 2 2 0 0 0 2 2 2 2
2 2 2 2 0 0 0 0 0 2 2 2 2 
2 2 2 2 0 0 2 2 2 2 2 0 0 
0 0 0 0 0 2 2 2 0 0 0 0 0
0 0 0 0 0 2 2 2 0 0 0 0 0
### Các trường dữ liệu khác SH HI TG SP IN EN
IN
6 2 6 2
EN
4 4
TG 2 2 6
2 12
TG 2 0 12
4 6
LSGOAL
2 6 0 12 4 4