level 13
10 14
2 2 2 1 2 2 2 2 1 2 2 2 2 0
2 2 0 0 0 0 0 0 0 0 2 2 2 0
2 2 0 0 0 0 0 0 0 0 0 2 2 2
2 2 2 0 0 0 2 2 2 0 0 2 2 2
2 2 2 1 1 1 2 2 2 0 0 2 2 2
2 2 2 0 0 1 2 2 2 0 0 2 0 0
0 0 2 0 0 1 1 1 1 1 2 2 0 0
0 0 2 2 2 1 1 2 1 1 1 0 0 0
0 0 0 2 2 1 1 1 1 1 1 0 0 0
0 0 0 2 2 2 0 0 2 2 0 0 0 0
### Các trường dữ liệu khác SH HI TG SP IN EN
IN
3 12 3 12
EN
4 7
LSGOAL
4 7