level 14
10 14
0 0 0 0 0 0 0 0 2 2 2 0 0 0
0 0 0 2 2 2 0 0 2 2 2 0 0 0
2 0 0 2 2 2 2 2 2 2 2 2 2 2
2 0 0 2 2 2 0 0 0 0 0 0 2 2
2 0 0 0 0 0 0 0 0 0 0 0 2 2
2 0 0 0 0 0 0 0 0 0 0 0 2 2
2 0 0 0 0 0 0 0 2 2 2 2 2 2
2 2 2 2 2 0 0 0 2 2 2 0 0 0
0 2 2 2 2 0 0 0 2 2 2 0 0 0
0 0 2 2 2 0 0 0 2 2 2 2 2 2
### Các trường dữ liệu khác SH HI TG SP IN EN
IN
2 4 2 4
EN
8 3
TG 2 9 13
3 1 3 2
TG 2 3 12
2 1 2 2
LSGOAL
9 13 3 12 6 11 8 3