level 15
10 15
0 0 0 0 0 0 0 2 2 2 0 0 2 2 2
0 0 0 0 2 2 2 2 2 2 0 0 2 2 2
2 2 0 0 2 0 0 2 2 2 0 0 2 2 2
2 2 2 2 2 0 0 0 2 0 0 0 0 0 0
2 2 0 0 0 0 0 0 0 0 0 0 0 0 0
0 2 0 0 0 0 0 2 0 0 0 0 0 0 0
0 2 0 0 0 0 0 2 0 0 0 0 0 0 0
2 2 2 0 0 0 2 2 2 0 0 2 2 2 0
2 2 2 2 2 2 2 2 2 2 2 2 2 2 0
2 2 2 0 0 0 2 2 2 0 0 2 2 2 0
### Các trường dữ liệu khác SH HI TG SP IN EN
IN
8 1 8 1
EN
8 12
TG 2 1 12
2 2 2 3 1 5 1 6 
SH 1 3 8
1 10 1 11
HI 1 3 8
1 5 1 6
SP 2 5 7
1 13 8 1
HI 1 7 11
8 9 8 10 
HI 1 9 11
8 9 8 10
LSGOAL
5 7 3 8 1 12 8 12 