level 16
8 13
0 2 0 0 0 0 0 0 0 0 2 2 2 
2 2 2 0 0 2 2 2 0 0 2 2 2 
0 2 0 0 0 0 0 0 0 0 2 2 2 
0 0 0 0 0 0 0 0 0 0 0 0 0 
0 0 0 0 0 0 0 0 0 0 0 0 0 
0 0 2 2 2 0 0 0 2 2 2 0 0 
0 0 2 2 2 2 2 2 2 2 2 0 0 
0 0 2 2 2 0 0 0 2 2 2 0 0 
### Các trường dữ liệu khác SH HI TG SP IN EN
IN
6 3 6 3
EN
1 11
SP 2 6 9
1 0 0 1
SP 2 1 2
1 0 1 2
SP 2 2 1
1 0 2 1
SP 2 1 0
0 1 1 0
SP 2 0 1
1 5 1 7
SH 2 1 5
1 3 1 4 
SH 2 1 6
1 8 1 9
LSGOAL
6 9 1 11