level 17
10 15
2 2 2 0 0 0 0 0 0 0 0 0 0 0 0
2 2 2 2 2 2 2 2 2 0 0 0 2 2 2
2 2 2 0 0 0 0 0 2 2 2 2 2 2 2
2 2 2 0 0 0 0 0 0 0 0 0 2 2 2
2 2 2 0 0 0 0 0 0 0 0 0 0 0 0
2 2 2 0 0 0 0 0 0 0 0 0 0 0 0
2 2 2 0 0 0 0 2 2 2 2 2 2 0 0
2 2 2 2 2 2 2 2 0 0 0 2 2 0 0
2 2 2 0 0 0 0 0 0 0 0 2 2 0 0 
2 2 2 0 0 0 0 0 0 0 0 2 2 0 0
### Các trường dữ liệu khác SH HI TG SP IN EN
IN
1 1 1 1
EN
2 13
TG 1 8 1
7 8
SH 2 6 12
2 7
SH 2 9 12
7 8
HI 2 9 12
1 9
HI 2 3 12
6 6
SH 2 3 13
6 6
LSGOAL
8 1 6 12 3 13 9 12 2 13