level 18
9 15
0 0 0 0 0 0 0 2 0 0 0 0 0 0 0
2 2 2 2 0 0 0 2 0 0 0 0 0 0 0
2 2 2 2 2 0 0 2 0 0 0 0 0 0 0
2 2 2 2 2 2 2 2 0 0 2 2 0 0 2
2 2 2 2 2 0 0 0 2 0 0 0 2 0 0
2 2 2 2 0 0 0 0 2 0 0 0 2 0 0
2 0 0 0 0 0 0 0 2 0 0 2 2 2 0
2 0 0 0 0 0 0 0 0 0 2 2 2 2 0
2 0 0 2 0 0 0 0 0 0 2 2 2 2 0 
### Các trường dữ liệu khác SH HI TG SP IN EN
IN
3 2 3 2
EN
7 12
HI 1 1 2
8 1 8 2 3 12 3 13
HI 1 3 1
3 8 3 9
HI 1 5 2
8 1 8 2 3 12 3 13
SH 2 0 7
3 8 3 9
SH 2 6 8
8 1 8 2 3 13 3 14
TG 2 8 3
4 5
LSGOAL
0 7 6 8 4 5 7 12