level 19
10 15
0 2 2 2 2 2 2 2 2 2 2 2 2 2 2
0 0 0 0 0 2 2 0 0 0 0 0 0 2 2 
0 0 0 0 0 2 2 0 0 0 0 0 0 2 2 
0 0 0 0 0 0 0 0 0 0 0 0 0 2 2
0 0 0 0 0 0 0 0 0 0 0 0 0 2 2
2 2 2 0 0 2 2 0 0 2 2 2 2 2 2
2 2 2 0 0 2 2 0 0 0 0 0 0 0 0 
2 2 2 0 0 2 2 0 0 0 0 0 0 0 0  
0 2 2 0 0 2 2 0 0 0 0 0 0 0 0
0 2 2 2 2 2 2 2 2 2 2 2 2 2 0
### Các trường dữ liệu khác SH HI TG SP IN EN
IN
0 1 0 1
EN
6 1
TG 1 0 10
5 7 5 8
HI 1 5 10
9 2 9 3
SH 2 9 10
9 2 9 3
LSGOAL
0 10 9 10 6 1