level 2
6 15
0 0 0 0 0 0 2 2 2 2 0 0 2 2 2
2 2 2 2 0 0 2 2 2 2 0 0 2 2 2
2 2 2 2 0 0 2 2 2 2 0 0 2 2 2
2 2 2 2 0 0 2 2 2 2 0 0 2 2 2
2 2 2 2 0 0 2 2 2 2 0 0 2 2 2
2 2 2 2 0 0 2 2 2 2 0 0 0 0 0
### Các trường dữ liệu khác SH HI TG SP IN EN
IN
4 1 4 1
EN
1 13
TG 1 2 2
4 4 4 5
TG 2 1 8
4 10 4 11
LSGOAL
2 2 1 8 1 13
