level 20
10 15
0 0 0 0 0 0 0 0 0 0 0 0 2 2 2
0 0 2 2 2 2 2 2 2 2 0 0 2 2 2 
0 0 2 2 2 0 0 2 2 2 0 0 2 2 2 
0 0 2 2 2 0 0 2 2 2 0 0 0 0 0
0 0 2 2 2 0 0 2 2 2 0 0 0 0 0
0 0 2 2 2 0 0 2 2 2 0 0 0 0 0
2 2 2 2 0 0 0 2 2 2 0 0 2 2 2 
2 2 0 0 0 0 0 0 0 0 0 0 2 2 2  
0 0 0 0 0 0 0 0 0 0 0 0 2 2 2
0 0 0 0 0 0 0 0 0 0 0 0 2 2 2
### Các trường dữ liệu khác SH HI TG SP IN EN
IN
8 2 8 2
EN
8 14
SP 2 4 7
1 14 7 14
HI 1 4 9
1 5 1 6
HI 1 2 7
1 5 1 6
TG 1 6 12 
6 10 6 11
HI 1 4 3
1 5 1 6
TG 1 7 1
1 10 1 11
LSGOAL
7 1 4 7 6 12 8 14