level 20
10 15
0 0 0 0 0 0 0 0 0 0 0 0 2 2 2
0 0 2 2 2 2 2 2 2 2 0 0 2 2 2 
0 0 2 2 2 0 0 2 2 2 0 0 2 2 2 
0 0 2 2 2 0 0 2 2 2 0 0 0 0 0
0 0 2 2 2 0 0 2 2 2 0 0 0 0 0
0 0 2 2 2 0 0 2 2 2 0 0 0 0 0
2 2 2 2 0 0 0 2 2 2 0 0 2 2 2 
2 2 0 0 0 0 0 0 0 0 0 0 2 2 2  
0 0 0 0 0 0 0 0 0 0 0 0 2 2 2
0 0 0 0 0 0 0 0 0 0 0 0 2 2 2
### Các trường dữ liệu khác SH HI TG SP IN EN
IN
2 8 2 8
EN
8 13
SP 2 4 7
7 13 1 13
HI 1 4 9
1 5 1 6
HI 1 2 7
1 5 1 6
TG 1 6 12 
6 10 6 11
HI 1 4 3
1 5 1 6
TG 1 7 1
1 10 1 11
IG
4 9 2 7 4 3
LSGOAL A
6 12 7 13
LSGOAL B
1 8 6 13
LSGOAL
6 7 7 1 8 13