level 21
10 15
0 0 0 0 0 0 0 0 2 2 0 0 0 0 0 
0 0 0 0 0 0 0 2 2 2 0 0 0 0 0  
2 2 0 0 2 2 2 2 2 2 0 0 0 0 0  
2 2 2 2 2 2 0 0 2 0 0 0 0 0 0 
2 2 2 2 0 0 0 0 2 0 0 0 2 2 2 
0 2 2 0 0 0 0 0 2 2 2 2 2 2 2 
0 0 2 0 0 0 0 0 2 2 0 0 2 2 2  
0 0 2 2 2 0 0 0 2 2 0 0 0 0 0   
0 0 0 2 2 2 0 0 2 2 0 0 0 0 0 
0 0 0 0 2 2 2 2 2 2 0 0 0 0 0 
### Các trường dữ liệu khác SH HI TG SP IN EN
IN
3 1 3 1
EN
5 13
TG 2 5 8
9 3
TG 2 6 8
7 5
LSGOAL
5 8 6 8 5 13