level 22
10 14
0 0 0 0 0 2 2 0 0 0 0 2 2 2
0 0 0 2 2 2 2 2 2 0 0 2 2 2  
2 2 2 2 2 2 2 2 2 2 2 2 2 2  
2 2 2 2 2 0 0 2 2 2 2 2 0 0 
2 2 2 0 0 0 0 0 0 2 2 2 0 0 
0 2 0 0 0 0 0 0 0 0 2 0 0 0 
0 2 0 0 0 0 0 0 0 0 2 0 0 0  
0 2 0 0 0 0 0 0 0 2 2 0 0 0   
0 2 2 0 0 0 0 0 0 2 2 0 0 0 
0 0 2 0 0 0 0 0 0 2 0 0 0 0 
### Các trường dữ liệu khác SH HI TG SP IN EN
IN
3 1 3 1
EN
1 12
HI 1 3 4
7 2 3 12
HI 1 2 6
7 2 3 12
TG 2 9 9
7 2
TG 2 9 2
3 12
IG
3 4 2 6
LSGOAL
9 9 9 2 1 12