level 23
10 15
0 2 2 2 0 0 2 0 0 0 0 0 2 2 2 
0 2 2 2 0 0 0 0 0 0 0 0 2 2 2 
0 2 2 2 0 0 0 2 2 2 2 2 2 2 2
0 2 2 2 0 0 0 2 2 2 0 0 2 2 2
2 0 0 0 2 0 0 2 2 2 0 0 0 0 2
2 0 0 0 2 0 0 1 1 1 0 0 0 0 2
2 0 0 2 2 2 1 1 1 1 1 2 2 2 2 
0 0 0 2 2 2 1 1 1 1 1 2 2 2 0 
0 0 0 2 2 2 1 1 1 1 1 2 2 2 0
0 0 0 2 2 2 2 2 0 0 0 0 0 0 0
### Các trường dữ liệu khác SH HI TG SP IN EN
IN
7 4 7 4
EN
3 8
SP 2 7 12
7 12 2 2
HI 1 3 14
6 14 2 10 2 11
S&T 1 1 13
6 1 6 2
9 8
S&H 1 5 0
3 0
6 1 6 2
SH 2 1 2
3 4
IG
3 14
LSGOAL A
1 13 2 7 5 0 3 2
LSGOAL
1 2 3 8