level 23
10 15
0 2 2 2 0 0 2 0 0 0 0 0 2 2 2 
0 2 2 2 0 0 0 0 0 0 0 0 2 2 2 
0 2 2 2 0 0 0 2 2 2 2 2 2 2 2
0 2 2 2 0 0 0 2 2 2 0 0 2 2 2
2 0 0 0 2 0 0 2 2 2 0 0 0 0 2
2 0 0 0 2 0 0 1 1 1 0 0 0 0 2
2 0 0 2 2 2 1 1 1 1 1 2 2 2 2 
0 0 0 2 2 2 1 1 1 1 1 2 2 2 0 
0 0 0 2 2 2 1 1 1 1 1 2 2 2 0
0 0 0 2 2 2 2 2 0 0 0 0 0 0 0
### Các trường dữ liệu khác SH HI TG SP IN EN
IN
7 4 7 4
EN
3 8
SP 2 7 12
7 12 2 2
HI 1 3 14
6 14 2 10 2 11
SH 1 1 13
6 1 6 2
TG 1 1 13
9 8 
HI 1 5 0
6 1 6 2
SH 1 5 0
3 0
SH 2 1 2
3 4
LSGOAL
7 12 1 13 5 0 1 2 3 8