level 24
8 14
0 0 0 0 0 0 0 0 0 0 2 2 2 2  
0 0 0 0 2 2 2 2 2 2 2 2 2 2  
0 2 0 0 2 2 2 0 0 0 2 2 2 2 
2 2 0 0 2 2 0 0 0 0 0 0 2 0 
2 2 0 0 2 0 0 0 0 0 0 0 2 0 
2 2 2 2 2 0 0 0 0 0 2 2 2 0 
2 2 2 0 0 2 2 2 0 0 2 2 2 0 
0 0 0 0 0 2 2 0 0 0 2 2 2 0 
### Các trường dữ liệu khác SH HI TG SP IN EN
IN
2 1 2 1
EN
6 11
SH 2 3 0
1 3
SH 2 1 11
2 2 2 3
SH 2 2 5
7 7
SH 2 7 7
6 8 6 9
SP 2 1 13
6 5 6 7
LSGOAL
2 3 1 11 2 5 1 13 7 7 6 11