level 25
10 14
0 0 2 2 0 0 0 0 0 0 0 0 0 0  
0 0 2 2 2 0 0 0 0 0 0 0 0 0  
0 0 2 2 2 0 0 0 0 0 2 2 2 0 
0 0 0 2 2 2 2 0 0 0 2 2 2 0 
0 0 0 0 0 0 2 2 0 0 2 2 2 0 
0 2 2 0 0 0 2 2 0 0 0 0 0 0 
2 2 2 2 2 2 2 2 0 0 0 0 0 0 
2 2 2 0 0 0 2 2 0 0 0 2 2 2
2 2 2 0 0 0 2 2 2 2 2 2 2 2
0 0 0 0 0 0 0 0 0 0 0 2 2 2 
### Các trường dữ liệu khác SH HI TG SP IN EN
IN
7 1 7 1
EN
3 11
SH 2 7 2
4 8 4 9
SH 2 8 8
3 7
HI 2 8 8
7 4 7 5
SH 1 2 4
2 13 3 13
HI 1 2 4
4 8 4 9
LSGOAL
7 2 2 4 7 2 3 11