level 26
9 14
0 0 0 0 0 2 2 2 2 0 0 0 0 2  
0 0 0 0 0 2 2 2 2 2 2 0 0 2  
0 0 0 0 2 2 2 2 2 2 2 0 0 2 
2 2 2 2 2 2 2 2 0 0 2 2 2 2 
2 2 2 0 0 0 2 0 0 0 2 2 0 0 
2 2 2 0 0 0 2 0 0 0 2 0 0 0 
0 2 0 0 0 0 2 2 2 0 0 0 0 0 
0 2 0 0 0 0 2 2 2 0 0 2 0 0
0 0 0 0 0 0 2 2 2 0 0 2 0 0
### Các trường dữ liệu khác SH HI TG SP IN EN
IN
5 10 5 10
EN
7 7
HI 1 1 7
4 2 4 3
SH 2 7 1
4 3 7 9
SP 2 0 13
3 12 5 10
LSGOAL
0 13 7 1 0 13 7 7