level 27
10 15
2 2 2 0 0 0 0 2 2 2 2 2 2 2 2 
2 2 2 2 2 2 2 2 2 2 2 0 0 2 2
2 2 2 0 0 0 0 2 2 0 0 0 0 2 2
0 0 0 0 0 0 0 0 0 0 0 0 2 2 2
0 0 0 0 0 0 0 0 0 0 0 0 2 2 0
2 2 2 0 0 1 1 1 1 2 0 0 2 2 0
2 2 2 1 1 1 1 1 1 1 0 0 2 2 2
2 2 2 1 1 1 1 1 1 1 1 1 2 2 2
0 0 0 0 0 1 1 1 1 1 1 1 2 2 2
0 0 0 0 0 0 2 2 2 2 0 0 0 0 0
### Các trường dữ liệu khác SH HI TG SP IN EN
IN
1 1 1 1
EN
6 1
HI 2 3 13
9 6 9 9
HI 1 5 12
9 6
HI 1 5 13
9 9
LSGOAL
0 8 0 0 3 12 9 9 5 9 6 1