level 28
10 15
0 2 2 2 2 2 2 0 0 0 0 0 0 0 0 
0 2 2 0 0 2 2 2 0 0 0 0 0 0 0
1 1 2 0 0 2 2 2 2 0 0 0 0 0 0
1 1 0 0 0 0 0 2 2 2 0 0 0 0 0
1 1 0 0 0 0 0 0 2 2 2 0 0 0 0
1 2 2 2 0 0 0 0 0 2 2 2 0 0 0
0 2 2 2 0 0 0 0 0 0 2 2 2 2 2
0 2 2 2 2 2 2 0 0 0 2 2 2 2 2
0 0 2 0 0 2 2 0 0 0 2 2 2 0 0
0 0 2 0 0 2 2 2 2 2 2 2 2 0 0
### Các trường dữ liệu khác SH HI TG SP IN EN
IN
2 2 2 2
EN
6 2
SP 2 5 11
9 12 6 14
HI 1 7 11
9 8 9 9
IG
7 11
LSGOAL A
8 2
LSGOAL B
7 2
LSGOAL
4 8 6 2