level 29
10 15
0 0 2 2 2 2 0 0 0 2 0 0 2 0 0 
0 0 0 0 0 2 0 0 0 2 0 0 0 0 0
0 0 0 0 0 2 2 2 2 2 0 0 0 0 0
2 0 0 2 2 2 2 2 2 2 2 2 0 0 2
0 0 0 0 0 2 2 2 2 2 0 0 0 0 0
0 0 0 0 0 0 2 0 0 2 0 0 0 0 0
0 0 0 0 0 0 2 0 0 2 2 2 2 0 0
2 2 2 0 0 2 2 0 0 2 0 0 0 0 0
2 2 2 0 0 2 0 0 0 2 0 0 0 0 0
2 2 2 0 0 0 0 0 0 2 2 2 2 0 0
### Các trường dữ liệu khác SH HI TG SP IN EN
IN
3 7 3 7
EN
8 1
SH 2 6 12
3 1 3 2
S&H 2 3 0
8 3 8 4
9 10 9 11
S&H 2 0 2
0 10 0 11
6 10 6 11
SH 2 0 12
5 5 6 5
S&H 2 9 12
3 12 3 13
6 10 6 11 0 10 0 11 0 3 0 4
SH 2 3 14
9 3
LSGOAL
6 12 0 2 0 12 9 12 3 14 3 0 8 1