level 29
10 15
0 0 2 2 2 2 0 0 0 2 0 0 2 0 0 
0 0 0 0 0 2 0 0 0 2 0 0 0 0 0
0 0 0 0 0 2 2 2 2 2 0 0 0 0 0
2 0 0 2 2 2 2 2 2 2 2 2 0 0 2
0 0 0 0 0 2 2 2 2 2 0 0 0 0 0
0 0 0 0 0 0 2 0 0 2 0 0 0 0 0
0 0 0 0 0 0 2 0 0 2 2 2 2 0 0
2 2 2 0 0 2 2 0 0 2 0 0 0 0 0
2 2 2 0 0 2 0 0 0 2 0 0 0 0 0
2 2 2 0 0 0 0 0 0 2 2 2 2 0 0
### Các trường dữ liệu khác SH HI TG SP IN EN
IN
3 7 3 7
EN
8 1
SH 2 6 12
3 1 3 2
SH 2 3 0
3 1 3 2
HI 2 3 0
9 10 9 11 
HI 2 0 2
6 10 6 11
SH 2 0 2
0 10 0 11
SH 2 0 12
5 5 6 5
SH 2 9 12
3 12 3 13
HI 2 9 12 
6 10 6 11 0 10 0 11 0 3 0 4
SH 2 3 14
9 3
LSGOAL
6 12 0 2 0 12 9 12 3 14 3 0 8 1