level 3
6 15
0 0 0 0 0 0 2 2 2 2 2 2 2 0 0
2 2 2 2 0 0 2 2 2 0 0 2 2 0 0
2 2 2 2 2 2 2 2 2 0 0 2 2 2 2
2 2 2 2 0 0 0 0 0 0 0 2 2 3 2
2 2 2 2 0 0 0 0 0 0 0 2 2 2 2
0 0 0 0 0 0 0 0 0 0 0 0 2 2 2
### Các trường dữ liệu khác SH HI TG SP IN EN
IN
3 1 3 1
EN
3 13
LSGOAL
3 13
