level 30
10 15
0 0 0 2 2 2 2 2 1 1 2 2 2 2 0 
0 0 0 2 2 2 2 0 0 0 0 0 1 2 0
0 0 0 2 2 2 0 0 0 0 0 0 1 2 2
0 0 0 0 0 0 0 1 2 2 2 2 2 2 2
0 0 2 0 0 0 0 1 1 0 0 0 0 0 2
0 2 2 1 0 0 0 1 1 0 0 0 0 0 2
1 1 1 1 0 0 0 2 2 0 0 0 0 2 2
1 1 1 2 1 2 1 1 2 1 0 0 2 2 0
2 1 1 1 1 1 1 1 1 1 1 1 2 0 0
0 1 2 1 1 1 0 0 1 1 1 1 2 0 0
### Các trường dữ liệu khác SH HI TG SP IN EN
IN
4 2 4 2
EN
1 4
SH 2 5 1
3 10 3 11
TG 2 7 12
7 14
SH 2 2 14
6 9 6 12
HI 2 2 14
3 10 3 11
LSGOAL
7 12 2 14 5 1 1 4
