level 31
10 15
0 0 0 0 0 0 0 0 0 0 0 2 2 2 0 
0 2 2 2 0 0 0 0 2 0 0 2 2 2 0
0 2 2 2 2 2 2 2 2 0 0 2 2 2 0
0 2 2 2 0 0 2 2 2 0 0 0 2 0 0
0 1 1 1 0 0 2 2 2 0 0 0 1 0 0
0 0 1 0 0 0 2 2 2 0 0 1 1 1 0
0 0 2 0 0 0 2 2 2 0 0 2 2 2 0
2 2 2 2 0 0 2 2 2 2 2 2 2 2 0
2 2 2 2 0 0 2 0 0 0 0 2 2 2 0
2 2 2 2 0 0 0 0 0 0 0 0 0 0 0
### Các trường dữ liệu khác SH HI TG SP IN EN
IN
7 12 7 12
EN
1 12
HI 1 7 7
7 9 7 10 2 9 2 10 2 4 2 5 7 4 7 5
HI 1 4 6
7 9 7 10 2 9 2 10 2 4 2 5 7 4 7 5
TG 2 1 8
2 9 2 10
TG 2 8 6
7 4 7 5
SH 2 8 2
0 14 1 14 2 14
IG
7 7 4 6
LSGOAL
1 8 8 6 8 2 1 12
