level 32
9 14
0 0 0 0 0 0 0 0 0 0 0 0 2 2  
0 0 2 2 2 2 2 2 0 0 0 2 2 2 
0 2 2 2 0 0 2 2 0 0 2 2 2 2 
0 2 2 2 0 0 0 2 2 2 2 2 0 0 
0 2 2 2 0 0 0 0 2 2 2 0 0 0 
0 0 0 0 0 0 0 0 0 2 2 0 0 0 
0 0 0 0 2 2 2 0 0 2 2 0 0 0 
2 2 0 0 2 2 2 0 0 2 2 0 0 0 
2 2 0 0 2 2 2 2 2 2 2 0 0 0 
### Các trường dữ liệu khác SH HI TG SP IN EN
IN
6 10 6 10
EN
3 2
TG 2 0 13
7 2 7 3 1 4 1 5
LSGOAL
1 8 8 6 8 2 1 12
