level 33
10 15
0 0 0 0 0 2 2 2 2 2 2 0 0 0 0 
0 0 0 0 0 2 2 2 2 2 2 0 0 0 0
2 2 2 0 0 2 2 2 2 2 2 2 2 2 0
2 2 2 2 2 2 2 2 2 2 2 2 2 2 0
0 0 0 0 0 2 2 2 2 2 2 2 2 2 0
0 0 0 0 0 2 2 2 2 2 2 2 2 2 0
2 2 2 0 0 2 2 2 2 2 2 2 2 2 2
2 2 2 2 2 2 2 2 0 0 2 2 2 2 2
2 2 2 0 0 2 2 2 0 0 0 2 2 2 2
2 2 2 0 0 0 0 0 0 0 0 0 2 2 2 
### Các trường dữ liệu khác SH HI TG SP IN EN
IN
3 1 3 1
EN
7 1
HI 1 2 5
7 3 7 4
HI 1 0 7
7 3 7 4
HI 1 2 8
7 3 7 4
HI 1 4 7
7 3 7 4
HI 1 7 6
7 3 7 4
HI 1 3 9
7 3 7 4
HI 1 3 10
7 3 7 4
HI 1 4 10
7 3 7 4
HI 1 3 13
7 3 7 4
HI 1 5 11
7 3 7 4
HI 1 6 11
7 3 7 4
HI 1 7 13
7 3 7 4
SH 2 7 14
1 11
IG
2 5 0 7 2 8 4 7 7 6 3 9 3 10 4 10 3 13 5 11 6 11 7 13
LSGOAL
7 14 7 1
