level 4
9 14
0 0 0 1 1 1 1 1 1 1 0 0 0 0
0 0 0 1 1 1 1 1 1 1 0 0 0 0
2 2 2 2 0 0 0 0 0 2 2 2 0 0
2 2 2 0 0 0 0 0 0 0 2 2 0 0
2 2 2 0 0 0 0 0 0 0 2 2 0 0
2 2 2 0 0 2 2 2 2 1 1 1 1 1
2 2 2 0 0 2 2 2 2 1 1 1 1 1
0 0 0 0 0 2 3 2 0 0 1 1 2 1
0 0 0 0 0 2 2 2 0 0 1 1 1 1
### Các trường dữ liệu khác SH HI TG SP IN EN
IN
5 1 5 1
EN
7 6
LSGOAL
7 6
