level 5
10 15
0 0 0 0 0 0 0 0 0 0 0 2 2 2 2
0 2 2 2 2 2 2 2 2 2 2 2 2 2 2
0 2 2 2 2 0 0 0 0 0 0 0 2 2 2
0 2 2 2 2 0 0 0 0 0 0 0 0 0 0
0 2 2 2 2 0 0 0 0 0 0 0 0 0 0
0 0 0 2 2 2 2 2 2 2 2 2 2 0 0
0 0 0 0 0 0 0 0 0 0 2 2 2 2 2
2 2 2 0 0 0 0 0 0 0 2 2 2 2 2
2 3 2 2 2 2 2 2 2 2 2 2 2 0 0
2 2 2 2 0 0 0 0 0 0 0 0 0 0 0
### Các trường dữ liệu khác SH HI TG SP IN EN
IN
1 13 1 13
EN
8 1
TG 1 1 8
1 4 1 5
SH 1 3 3
8 5 8 6
HI 1 5 6
8 5 8 6
TG 1 6 14
8 5 8 6
LSGOAL
1 8 1 8 3 3 5 6 6 14 8 1
