level 6
10 15
0 0 0 0 0 2 2 2 2 2 2 0 0 0 0
0 0 0 0 0 2 0 0 2 2 2 0 0 0 0
0 0 0 0 0 2 0 0 2 2 2 2 2 0 0
2 2 2 2 2 2 0 0 0 0 0 2 2 2 2
0 0 0 0 2 2 2 0 0 0 0 2 2 2 2
0 0 0 0 2 2 2 0 0 0 0 0 2 2 2 
0 0 0 0 0 0 2 0 0 2 2 0 0 0 0
0 0 0 0 0 0 2 2 2 2 2 0 0 0 0
0 0 0 0 0 0 2 2 2 2 2 0 0 0 0
0 0 0 0 0 0 0 2 2 2 0 0 0 0 0
### Các trường dữ liệu khác SH HI TG SP IN EN
IN
3 0 3 0
EN
4 13
LSGOAL
4 13
