level 7
8 15
0 0 0 0 0 0 0 0 2 2 2 2 0 0 0
0 0 0 0 0 0 0 0 2 2 2 2 0 0 0
2 2 2 0 0 0 0 0 2 0 0 2 2 2 2
2 2 2 2 2 2 2 2 2 0 0 0 2 2 2
2 2 2 0 0 0 0 2 2 2 0 0 2 2 2
2 2 2 0 0 0 0 2 2 2 0 0 2 2 2 
0 2 2 0 0 0 0 2 0 0 0 0 0 0 0
0 0 2 2 2 2 2 2 0 0 0 0 0 0 0
### Các trường dữ liệu khác SH HI TG SP IN EN
IN
1 1 1 1
EN
3 13
TG 2 4 9
6 3
LSGOAL
4 9 3 13
