level 8
8 15
0 0 0 0 0 0 0 0 0 2 2 2 0 0 0
0 0 0 0 0 0 0 0 0 2 2 2 0 0 0
0 0 0 0 0 0 0 0 0 2 2 2 0 0 0
2 2 2 2 2 2 0 0 0 2 2 2 2 2 2
2 2 2 2 2 2 0 0 0 2 2 2 2 2 2
2 2 2 2 2 2 0 0 0 2 2 2 2 2 2 
0 0 0 0 0 0 0 0 0 2 2 2 0 0 0
0 0 0 0 0 0 0 0 0 2 2 2 0 0 0
### Các trường dữ liệu khác SH HI TG SP IN EN
IN
4 1 4 1
EN
4 13
SP 2 4 4
1 10 7 10
LSGOAL
4 4 4 13