level 9
5 15
2 2 2 2 0 0 0 2 0 0 0 2 2 2 2
2 2 2 2 0 0 0 2 0 0 0 2 2 2 2
2 2 2 2 2 2 2 2 2 2 2 2 2 2 2
0 0 0 0 0 0 2 2 2 0 0 0 0 0 0
0 0 0 0 0 0 2 2 2 0 0 0 0 0 0
### Các trường dữ liệu khác SH HI TG SP IN EN
IN
1 1 1 1
EN
3 7
SP 2 1 13
1 12 1 2
LSGOAL
1 13 3 7